XXX 1E0 1E0 1E0 1E0 1E0 1E0 1E0 1E0 1E0 1E0 1E0 1E0 1E0 1E0 1E0 1E0 1E0 1E0 XXX
XXX 1E0 1E0 1E0 1E0 1E0 1E0 1E0 1E0 1E0 1E0 1E0 1E0 1E0 1E0 1E0 1E0 1E0 1E0 XXX
XXX 1E0 1E0 1E0 1E0 1E0 1E0 1E0 1E0 1E0 1E0 1E0 1E0 1E0 1E0 1E0 1E0 1E0 1E0 XXX
XXX XXX XXX 1E1 1E1 XXX XXX 1E1 1E1 XXX XXX 1E1 1E1 XXX XXX 1E1 1E1 XXX XXX XXX
XXX XXX XXX 1E1 1E1 XXX XXX 1E1 1E1 XXX XXX 1E1 1E1 XXX XXX 1E1 1E1 XXX XXX XXX
XXX XXX 100 100 100 XXX XXX 100 100 XXX XXX 100 100 XXX XXX 100 100 100 XXX XXX
XXX 100 100 100 100 100 100 100 100 100 100 100 100 100 100 100 100 100 100 XXX
XXX 100 100 100 100 100 100 100 100 100 100 100 100 100 100 100 100 100 100 XXX
XXX XXX 100 100 XXX 100 XXX XXX 100 100 100 100 XXX XXX 100 XXX 100 100 XXX XXX
XXX XXX 100 100 XXX 100 XXX XXX 100 100 100 100 XXX XXX 100 XXX 100 100 XXX XXX