XXX XXX XXX XXX XXX 0E0 0E0 0E0 0E0 0E0 0E0 0E0 0E0 0E0 0E0 XXX XXX XXX XXX XXX
XXX XXX XXX XXX 1E0 2E0 1E0 1E0 0E0 1E0 1E0 1E0 0E0 1E0 2E0 1E0 XXX XXX XXX XXX
XXX XXX XXX 1E0 2E0 2E0 2E0 1E0 1E0 1E0 1E0 1E0 1E0 2E0 2E0 2E0 0E0 XXX XXX XXX
XXX XXX 1E0 2E0 2E0 2E0 1E0 2E0 1E0 1E0 1E0 1E0 2E0 2E0 2E0 2E0 2E0 0E1 XXX XXX
XXX 0E0 2E0 0E0 XXX 1E1 XXX 2E0 2E0 1E0 1E0 2E0 2E0 XXX 1E1 XXX 1E0 2E0 0E0 XXX
XXX 2E0 2E0 1E0 XXX 1E1 XXX 2E0 2E0 XXX XXX 2E0 2E0 XXX 1E1 XXX 1E0 2E0 2E0 XXX
XXX XXX 0E1 1E1 1E1 0E1 0E1 1E1 1E1 0E1 0E1 1E1 1E1 0E1 0E1 1E1 1E1 0E1 XXX XXX
XXX XXX XXX 200 200 200 200 200 200 200 200 200 200 200 200 200 200 XXX XXX XXX
XXX XXX XXX XXX 200 200 200 200 200 200 200 200 200 200 200 200 XXX XXX XXX XXX
XXX XXX XXX XXX XXX XXX XXX XXX XXX XXX XXX XXX XXX XXX XXX XXX XXX XXX XXX XXX