XXX XXX XXX XXX XXX 1E0 1E0 XXX 1E0 XXX 1E0 XXX 1E0 1E0 1E0 XXX XXX XXX XXX XXX
XXX XXX XXX XXX 1E0 1E0 1E0 XXX 1E0 XXX 1E0 XXX 1E0 1E0 1E0 1E0 XXX XXX XXX XXX
XXX XXX XXX 1E0 1E0 1E0 1E0 1E0 1E0 1E0 1E0 1E0 1E0 1E0 1E0 1E0 1E0 XXX XXX XXX
XXX XXX 1E0 1E0 1E0 XXX XXX 1E1 1E1 1E1 1E1 1E1 1E1 XXX XXX 1E0 1E0 1E0 XXX XXX
XXX 1E1 1E1 1E1 1E1 XXX XXX 200 200 200 200 200 200 XXX XXX 1E1 1E1 1E1 1E1 XXX
200 200 200 200 XXX XXX 200 200 200 200 200 200 200 200 XXX XXX 200 200 200 200
200 200 200 XXX XXX 200 200 200 200 200 200 200 200 200 200 XXX XXX 200 200 200
200 200 200 XXX XXX 200 200 200 200 XXX XXX 200 200 200 200 XXX XXX 200 200 200
200 200 200 XXX XXX 200 200 200 200 XXX XXX 200 200 200 200 XXX XXX 200 200 200
200 200 200 XXX XXX 200 200 200 200 XXX XXX 200 200 200 200 XXX XXX 200 200 200