2E1 2E1 2E0 2E0 2E1 2E1 2E0 2E0 2E1 2E0 2E0 2E1 2E0 2E0 2E1 2E1 2E0 2E0 2E1 2E1
XXX 2E1 1E0 1E0 1E0 1E0 1E0 1E0 1E0 1E0 1E0 1E0 1E0 1E0 1E0 1E0 1E0 1E0 2E1 XXX
XXX XXX 2E1 1E0 1E0 1E0 1E0 1E0 1E0 1E0 1E0 1E0 1E0 1E0 1E0 1E0 1E0 2E1 XXX XXX
XXX XXX XXX 2E1 1E0 1E0 1E0 1E0 1E0 1E0 1E0 1E0 1E0 1E0 1E0 1E0 2E1 XXX XXX XXX
XXX XXX XXX XXX 2E1 1E0 1E0 1E0 1E0 1E0 1E0 1E0 1E0 1E0 1E0 2E1 XXX XXX XXX XXX
XXX XXX XXX XXX XXX 2E1 1E0 1E0 1E0 1E0 1E0 1E0 1E0 1E0 2E1 XXX XXX XXX XXX XXX
XXX XXX XXX XXX XXX XXX 2E1 1E0 1E0 1E0 1E0 1E0 1E0 2E1 XXX XXX XXX XXX XXX XXX
XXX XXX XXX XXX XXX XXX XXX 2E1 1E0 1E0 1E0 1E0 2E1 XXX XXX XXX XXX XXX XXX XXX
XXX XXX XXX XXX XXX XXX XXX XXX 2E1 1E0 1E0 2E1 XXX XXX XXX XXX XXX XXX XXX XXX
XXX XXX XXX XXX XXX XXX XXX XXX XXX 2E1 2E1 XXX XXX XXX XXX XXX XXX XXX XXX XXX