0E0 0E0 0E0 0E0 0E0 0E0 0E0 0E0 0E0 0E0 0E0 0E0 0E0 0E0 0E0 0E0 0E0 0E0 0E0 0E0
0E0 0E0 0E0 0E0 0E0 0E0 0E0 0E0 0E0 0E0 0E0 0E0 0E0 0E0 0E0 0E0 0E0 0E0 0E0 0E0
0E0 0E0 1E0 1E0 1E0 0E0 1E0 1E0 1E0 0E0 1E0 0E0 0E0 1E0 0E0 1E0 1E0 1E0 0E0 0E0
0E0 0E0 0E0 0E0 1E0 0E0 1E0 0E0 1E0 0E0 1E0 0E0 0E0 1E0 0E0 1E0 0E0 1E0 0E0 0E0
0E0 0E0 0E0 0E0 1E0 0E0 1E0 0E0 1E0 0E0 1E0 0E0 0E0 1E0 0E0 1E0 0E0 1E0 0E0 0E0
0E0 0E0 0E0 0E0 1E0 0E0 1E0 1E0 1E0 0E0 1E0 0E0 0E0 1E0 0E0 1E0 1E0 1E0 0E0 0E0
0E0 0E0 1E0 0E0 1E0 0E0 1E0 0E0 1E0 0E0 1E0 0E0 0E0 1E0 0E0 1E0 0E0 1E0 0E0 0E0
0E0 0E0 1E0 1E0 1E0 0E0 1E0 0E0 1E0 0E0 0E0 1E0 1E0 0E0 0E0 1E0 0E0 1E0 0E0 0E0
0E0 0E0 0E0 0E0 0E0 0E0 0E0 0E0 0E0 0E0 0E0 0E0 0E0 0E0 0E0 0E0 0E0 0E0 0E0 0E0
0E0 0E0 0E0 0E0 0E0 0E0 0E0 0E0 0E0 0E0 0E0 0E0 0E0 0E0 0E0 0E0 0E0 0E0 0E0 0E0